"tests"	"positive"	"negative"	"other"	"teryt"	"date"
1	0	1	0	"t0204"	"20231210"
6	6	0	0	"t0211"	"20231210"
3	1	2	0	"t0223"	"20231210"
1	1	0	0	"t0262"	"20231210"
7	3	4	0	"t0264"	"20231210"
2	2	0	0	"t0402"	"20231210"
4	4	0	0	"t0410"	"20231210"
1	1	0	0	"t0412"	"20231210"
1	0	1	0	"t0413"	"20231210"
1	1	0	0	"t0416"	"20231210"
3	1	2	0	"t0419"	"20231210"
1	1	0	0	"t0461"	"20231210"
1	1	0	0	"t0463"	"20231210"
2	0	2	0	"t0464"	"20231210"
1	0	1	0	"t0601"	"20231210"
5	2	3	0	"t0607"	"20231210"
2	0	2	0	"t0608"	"20231210"
9	3	6	0	"t0609"	"20231210"
1	0	1	0	"t0610"	"20231210"
1	0	1	0	"t0611"	"20231210"
1	0	1	0	"t0612"	"20231210"
1	0	1	0	"t0614"	"20231210"
1	0	1	0	"t0615"	"20231210"
1	1	0	0	"t0616"	"20231210"
3	0	3	0	"t0617"	"20231210"
2	2	0	0	"t0618"	"20231210"
3	0	3	0	"t0620"	"20231210"
25	8	17	0	"t0663"	"20231210"
1	0	1	0	"t0802"	"20231210"
1	0	1	0	"t0808"	"20231210"
1	1	0	0	"t0810"	"20231210"
2	2	0	0	"t0811"	"20231210"
1	0	1	0	"t1005"	"20231210"
16	2	14	0	"t1016"	"20231210"
2	2	0	0	"t1061"	"20231210"
1	0	1	0	"t1062"	"20231210"
1	1	0	0	"t1201"	"20231210"
5	1	4	0	"t1202"	"20231210"
1	0	1	0	"t1203"	"20231210"
1	1	0	0	"t1205"	"20231210"
5	1	4	0	"t1206"	"20231210"
1	0	1	0	"t1209"	"20231210"
12	0	12	0	"t1213"	"20231210"
2	2	0	0	"t1215"	"20231210"
1	0	1	0	"t1216"	"20231210"
1	0	1	0	"t1219"	"20231210"
15	4	11	0	"t1261"	"20231210"
5	2	3	0	"t1401"	"20231210"
2	0	2	0	"t1403"	"20231210"
6	1	5	0	"t1406"	"20231210"
1	0	1	0	"t1407"	"20231210"
1	0	1	0	"t1410"	"20231210"
9	4	5	0	"t1412"	"20231210"
2	0	2	0	"t1413"	"20231210"
1	0	1	0	"t1414"	"20231210"
1	0	1	0	"t1415"	"20231210"
4	2	2	0	"t1417"	"20231210"
2	2	0	0	"t1418"	"20231210"
2	2	0	0	"t1421"	"20231210"
2	1	1	0	"t1425"	"20231210"
12	2	10	0	"t1426"	"20231210"
2	1	1	0	"t1432"	"20231210"
1	1	0	0	"t1433"	"20231210"
1	1	0	0	"t1434"	"20231210"
1	0	1	0	"t1436"	"20231210"
6	1	5	0	"t1462"	"20231210"
4	1	3	0	"t1463"	"20231210"
10	4	6	0	"t1464"	"20231210"
311	12	299	0	"t1465"	"20231210"
1	0	1	0	"t1601"	"20231210"
1	0	1	0	"t1605"	"20231210"
1	1	0	0	"t1609"	"20231210"
1	0	1	0	"t1661"	"20231210"
1	1	0	0	"t1804"	"20231210"
1	1	0	0	"t1808"	"20231210"
1	1	0	0	"t1809"	"20231210"
1	1	0	0	"t1814"	"20231210"
2	2	0	0	"t1816"	"20231210"
4	4	0	0	"t1817"	"20231210"
6	1	5	0	"t2002"	"20231210"
5	1	4	0	"t2003"	"20231210"
9	3	6	0	"t2008"	"20231210"
1	0	1	0	"t2010"	"20231210"
3	2	1	0	"t2011"	"20231210"
7	1	6	0	"t2061"	"20231210"
3	2	1	0	"t2201"	"20231210"
6	2	4	0	"t2202"	"20231210"
2	0	2	0	"t2203"	"20231210"
18	0	18	0	"t2204"	"20231210"
25	0	25	0	"t2205"	"20231210"
2	0	2	0	"t2206"	"20231210"
2	0	2	0	"t2207"	"20231210"
4	0	4	0	"t2208"	"20231210"
1	0	1	0	"t2209"	"20231210"
2	0	2	0	"t2210"	"20231210"
2	0	2	0	"t2212"	"20231210"
5	1	4	0	"t2213"	"20231210"
4	0	4	0	"t2214"	"20231210"
4	1	3	0	"t2215"	"20231210"
2	0	2	0	"t2216"	"20231210"
104	20	84	0	"t2261"	"20231210"
17	3	14	0	"t2262"	"20231210"
2	0	2	0	"t2263"	"20231210"
2	0	2	0	"t2264"	"20231210"
1	0	1	0	"t2401"	"20231210"
1	1	0	0	"t2404"	"20231210"
1	0	1	0	"t2408"	"20231210"
11	1	10	0	"t2413"	"20231210"
2	0	2	0	"t2414"	"20231210"
2	1	1	0	"t2415"	"20231210"
5	0	5	0	"t2462"	"20231210"
1	0	1	0	"t2463"	"20231210"
2	1	1	0	"t2467"	"20231210"
7	3	4	0	"t2469"	"20231210"
2	0	2	0	"t2471"	"20231210"
1	0	1	0	"t2472"	"20231210"
1	0	1	0	"t2475"	"20231210"
2	1	1	0	"t2603"	"20231210"
3	3	0	0	"t2605"	"20231210"
1	1	0	0	"t2610"	"20231210"
2	2	0	0	"t2611"	"20231210"
1	0	1	0	"t2802"	"20231210"
1	0	1	0	"t2803"	"20231210"
1	0	1	0	"t2805"	"20231210"
1	0	1	0	"t2809"	"20231210"
1	1	0	0	"t2815"	"20231210"
1	0	1	0	"t2861"	"20231210"
3	1	2	0	"t2862"	"20231210"
1	1	0	0	"t3003"	"20231210"
1	1	0	0	"t3012"	"20231210"
14	4	10	0	"t3017"	"20231210"
2	0	2	0	"t3018"	"20231210"
8	0	8	0	"t3021"	"20231210"
1	0	1	0	"t3022"	"20231210"
1	1	0	0	"t3023"	"20231210"
1	0	1	0	"t3026"	"20231210"
1	1	0	0	"t3028"	"20231210"
1	0	1	0	"t3062"	"20231210"
2	0	2	0	"t3064"	"20231210"
1	0	1	0	"t3206"	"20231210"
1	1	0	0	"t3208"	"20231210"
2	1	1	0	"t3209"	"20231210"
5	2	3	0	"t3210"	"20231210"
7	1	6	0	"t3214"	"20231210"
1	0	1	0	"t3262"	"20231210"
80	15	65	0	NA	"20231210"
